................
..****.......*..
..*..*.....****.
..**.*....**....
....*...........
..*......***....
.....*..........
................